.**...*...
..**.*....
....*.....
*..*..*...
*.*....*..
...***..*.
.....*.*.*
.**....*..
.*.***....
....*.....
